........
........
........
..$.....
########
........

